app
{
}

app
{
	app : sys::app::window
	{
		"+-------------------------------+"
		"+ My app # 2                    +"
		"+-------------------------------+"
		"+                               +"
		"+        Hellow, World!         +"
		"+                               +"
		"+-------------------------------+"
	}
}

app
{
}

app
{
}
